****************
*         *   S*
*    *    *  ***
*E   *         *
*    *    *    *
*         *    *
*    *         *
****************
